-xxxxxxxxxxxxxxxxxxxxxxxx---------------------
-x----------------------x---------------------
-x-xxxxxxxxxxxxxxxxxxx--x---------------------
-x-x-----------------x--x---------------------
-x-x-------oooooooooooooooooooooooo-----------
-x-x-------oooooooooooooooooooooooo-----------
-x-x-------oo---------oo---------oo-----------
-x-x-------oo---------oo---------oo-----------
-x-x-------oo---------oo---------oo-----------
-x-x-------oo---------oo---------oo-----------
-x-x-------p----------p----------p------------
-x-x-------p----------p----------p-------x-x--
-----------p----------p----------p-------x-x--
-----------oo---------oo---------oo------x-x--
-----------oo---------oo---------oo------x-x--
-----------oo---------oo---------oo------x-x--
-----------oo---------oo---------oo------x-x--
-----------oooooooooooooooooooooooo------x-x--
-----------oooooooooooooooooooooooo------x-x--
---------------------x--x----------------x-x--
---------------------x--x----------------x-x--
---------------------x--xxxxxxxxxxxxxxxxxx-x--
---------------------x---------------------x--
---------------------xxxxxxxxxxxxxxxxxxxxxxx--