----------------------------------------------
-xxxxxxxxxxxxxxxxxxxxxxx----------------------
-x---------------------x----------------------
-x-xxxxxxxxxxxxxxxxxxx-x----------------------
-x-x-----------------x-x----------------------
-x-x-------ooooooooooooooooooooooo------------
-x-x-------o----------o----------o------------
-x-x-------o----------o----------o------------
-x-x-------o----------o----------o------------
-x-x-------o----------o----------o------------
-x-x-------p----------p----------p------------
-x-x-------p----------p----------p-------x-x--
-----------p----------p----------p-------x-x--
-----------o----------o----------o-------x-x--
-----------o----------o----------o-------x-x--
-----------o----------o----------o-------x-x--
-----------o----------o----------o-------x-x--
-----------ooooooooooooooooooooooo-------x-x--
---------------------x-x-----------------x-x--
---------------------x-x-----------------x-x--
---------------------x-xxxxxxxxxxxxxxxxxxx-x--
---------------------x---------------------x--
---------------------xxxxxxxxxxxxxxxxxxxxxxx--
----------------------------------------------