-xxxxxxxxxxxxxxxxxxxxxxx----------------------
-x---------------------x----------------------
-x-xxxxxxxxxxxxxxxxxxx-x----------------------
-x-x-----------------x-x----------------------
-x-x-------yyyyyyyyyyyyyyyyyyyyyyyy-----------
-x-x-------yyyyyyyyyyyyyyyyyyyyyyyy-----------
-x-x-------yy---------yy---------yy-----------
-x-x-------yy---------yy---------yy-----------
-x-x-------yy---------yy---------yy-----------
-x-x-------yy---------yy---------yy-----------
-x-x-------p----------p----------p------------
-x-x-------p----------p----------p-------x-x--
-----------p----------p----------p-------x-x--
-----------yy---------yy---------yy------x-x--
-----------yy---------yy---------yy------x-x--
-----------yy---------yy---------yy------x-x--
-----------yy---------yy---------yy------x-x--
-----------yyyyyyyyyyyyyyyyyyyyyyyy------x-x--
-----------yyyyyyyyyyyyyyyyyyyyyyyy------x-x--
---------------------x-x-----------------x-x--
---------------------x-x-----------------x-x--
---------------------x-xxxxxxxxxxxxxxxxxxx-x--
---------------------x---------------------x--
---------------------xxxxxxxxxxxxxxxxxxxxxxx--